                                                                                                                                
                                                                                                                                
                                                                                                                                
                                                                                                                                
                                                                                                                                
                                                                                                                                
                                                                                                                                
                                                                                                                                
                                                                                                                                
                                                                    #.####                                                      
                                                                    #    ...###                                                 
                                                                  ##         .                                                  
                                                                 #.          . #                                                
                                                                 #           . #                                                
                                                                #.            . #   # #########                                 
                                                                .              .   ##..      ..##                               
                                                               #.               ....           .                                
                                                 #            #                                ..##                             
                                           ###  ##...###     #.                                  .##                            
                                           #.....      .##  #.                                    .#                            
                                           #            ....                                      . #                           
                                          #.                               ..                     .                             
                                          #                              ..  .                     .#                           
                                         #.                              .   ..                    .                            
                                        #.                              . #  ##.                   . #                          
                                        #.                            .. #     #.                   .##                         
                                      ##                            ..  ##      #..                 ..#                         
                                     #.                            .    #       ###...             .                            
                                     #                             .              ### ...         .   .                         
                                    #.                             . #               ### .       ..  ..                         
                                   #.                              .#                   # .     .   . ..##                      
                           #.###  #..                ...          . #                    # .   ..   .   .                       
                           #   ....                ..   .         . #                      .  .    .    .                       
                    ####  .                        . #   .        . #                     #.  .    .     .##                    
                    #  ....                       . #    .        .                       #...    .       .#                    
                    #                             .#    .          .  ###.###...###        .      .       .##                   
                    #                          ...##   #            ...   ..      .#     #..     .         .#                   
                    .                         .  ##    #                  .       .   ###.      ..         .#                   
                    .                         .        ##.               .         ..... .      .      .... #                   
                   #                          .         # .              .             ..       .      .  # #                   
                   #                          .          #..            .              .       .      .                         
                   #                          .. #         .           ..            ..        .      . #                       
                   #.                           ..##       .           .            .         .       .#                        
                   #.                             . #       ...       .             .         .      ..#                        
                    .                              .#      ## .       .           ..         .      . #                         
                   #.                         .... .#        # .     .            .         ..     .  #                         
                   #.                         .   ..#          .    .           ..          .     .  #                          
                   #.                        .    ##          #.   .            .          .      .                             
                   #.                        .                #.   .           .           .      . #                           
                    .                        . #              #.  .          ..           .       .#                            
                   ##.                       . #              #   .          .            .       .#                            
                    #.                       . #              .  .         ..             .      . #                            
                     .                        .#              # .          .             .       . #                            
                     #.                       .#              # .         .             ..    ... #                             
                     #.                       .#             #..         .              .     .   #                             
                     #...                     .            ## ...       .              .     .                                  
                      ## ..                   . #         ##     .    ..               .     .                                  
                       ## .                    .         #.       .   .               .      . #                                
                           .                    ..######.          ...                .       .#                                
                           .                                        ..               .        .#                                
                          .                                        . .              ..        .#                                
                          #                                       .   ..            .         .#                                
                         ##.                                     .      .           .        ..#                                
                          #.                                    .        .         .         .                                  
                          ##.                                   .         .        .        .                                   
                            .                                              ..     .          .                                  
                            .                                               ..    .          .  #                               
                           #.                                             .....  .            ...##                             
                           #                                          ....     ...                . #                           
                           #                                         .    ###   .                 . #                           
                           .                                        .    #      #.                 .                            
                          #.                                        . #         ##.                .. ##                        
                          #                                        . #           # .                 ..##                       
                          #                                       .  #            # .               .. .##                      
                         #.                                      .  #               .              .  . #                       
                          .                                      .                  .             .                             
                       # .                                        .               #.              .                             
                      #..                                         ..#            ..               .                             
                    ##                                              ##          ##                . #                           
                    #                                              .             #                 .#                           
                   .                                               .##           #                 .#                           
                   #                                              . #            .                 .##                          
                   #                                             .  #           #.                 . #                          
                   #.                                            . #            #                   .#                          
                   #.                                           . #             #                   .#                          
                   #.                                           . #             #                   .#                          
                    .                                          . #              .                  . #                          
                   #.                                         ..##             #.                  .                            
                   #                                          . #              #                   .                            
                   #                                         .                 #                   .#                           
                   #                                          .                #.                 ..#                           
                   #                                          .                 .             ....                              
                   #.                                          ..##            ..            .    ##                            
                    .                                            .##          #             .    #                              
                   ##.                                            .#          #       .......##                                 
                     .                                            .#         #.     ..    ####                                  
                     .                                            .         #.      .  #  #                                     
                     #.                                            . #     #.      .  #                                         
                     ##                                            ...## ##.       . #                                          
                      #.        .........                             ....         .#                                           
                      # ........         ....                                      .#                                           
                       ####################  .........                            .                                             
                                           ########  .                           .                                              
                                                     .                            .                                             
                                                     .                            .#                                            
                                                     #..                         . #                                            
                                                      # .                        . #                                            
                                                       #.                       .                                               
                                                        #.                      . #                                             
                                                         #.                     .#                                              
                                                           ..                   .#                                              
                                                          ##.                 ...#                                              
                                                            #..              .                                                  
                                                             # .         .... #                                                 
                                                              #..        .  ##                                                  
                                                               ##........##                                                     
                                                                ## ##### #                                                      
                                                                                                                                
                                                                                                                                
                                                                                                                                
                                                                                                                                
                                                                                                                                
                                                                                                                                
                                                                                                                                
                                                                                                                                
                                                                                                                                
                                                                                                                                
                                                                                                                                
