                                                                                                                                
                                                                                                                                
                                                                                                                                
                                                                                                                                
                                                                                                                                
                                                                                                                                
                                                                                                                                
                                                                                                                                
                                                                     #######                                                    
                                                                    #.......##                                                  
                                                                   #..........#                                                 
                                                                  #............#                                                
                                                                 #..............#                                               
                                                                #...............###  ##########                                 
                                                               #...................##..........##                               
                                                              #..................................#                              
                                                  ###         #...................................#                             
                                            ######...###     #....................................#                             
                                           #............#####......................................#                            
                                          #.........................................................#                           
                                          #.........................................................#                           
                                         #...........................................................#                          
                                         #..............   ..........................................#                          
                                        #...............   ...........................................#                         
                                       #................   ...........................................#                         
                                       #..................................#####.......................#                         
                                      #.................   ..............#     #.......................#                        
                                     #..................   .............#       #......................##                       
                                    #...................   .............#        ##......................#                      
                                   #....................   ...........##           ##....................#                      
                            #######.....................   ..........#               ###.................#                      
                        ####............................   ..........#                  #.................#                     
                     ###................................   ..........#                  #..................#                    
                    #....    ...........................   ..........#        ##         #.................#                    
                   #..       ........................##.   ...........########..###      #..................#                   
                   #.        .......................# #.   ........................##   #...................#                   
                   #.        ......................#  #.   ..........             ...####....................#                  
                  #..        .....................#   #..  ..........               .........................#                  
                  #.     .........................#    #.  ..........                     ...................#                  
                  #.     .   .....................#    #.. ..........                     ..................#                   
                  #.     .   .....................#     #. ..........                     ................##                    
                  #.     .   .....................##    #............                     ...............#                      
                  #.     ...........................#    #...........                     ..............#                       
                  #.       ....................... ..#   #...........                     ..............#                       
                  #.       .......................  .#    #..........                     .............#                        
                  #.       .......................  .#     ##........                     .............#                        
                  #.       ....................... ..#      #........                     ............#                         
                  #.       .........................#        #.......                     ............#                         
                  #.       .......................##         #.......                     ...........#                          
                  #..      .....................##           #.......                     ..........#                           
                   #.      .....................#            #.......                     ..........#                           
                   #.      .....................#            #.......                     ..........#                           
                   #..     .....................#            #.......                     .........#                            
                    #.     .....................#            #.......                     .........#                            
                    #..    .....................#          ##........                     ........#                             
                     #..   ......................#        #..........                     ........#                             
                      #..  ......................#      ###.  .......                     .......#                              
                       #.. .......................######....  .......                     ......#                               
                        #. ..................... ........     .......                     ......#                               
                        #. .....................              .......                     ......#                               
                        #.......................              .......                     ......#                               
                         #......................              .......                     ......#                               
                         #......................              .......                     ......#                               
                         #......................              .......                     ......#                               
                          #..........................................                     ......#                               
                          #.....................              .......                     .......#                              
                          #.....................              .......                     .......##                             
                          #.........   .........              .......                     .........#                            
                          #.........   .........              .......                     ......  ..#                           
                          #.........   .........              .......    ......           ......   ..#                          
                         #......................              .......  ...####....        ......    ..#                         
                         #..........   .........              ..........##    ###.        ......     ..#                        
                         #..........   .........              ........##        #..       ......      ..#                       
                         #..........   .........              ........#          #.       ......       ..#                      
                        #...........   .........              .......#           #.       ......        .#                      
                       #.. .........   .........              .......#           #.       ......        .#                      
                      #..  .........   .........              .......#           #.       ......    .....#                      
                    ##..   .........   .........              .......#          #..       ......    .#..#                       
                   #...    .........   .........              .......#          #.        ......    .#.#                        
                   #.      .........   .........              ........#         #.        ......    .##                         
                  #..      .........   ..      .              .......#          #.        ......    .#                          
                  #.       .........   ..      .              .......#         #..        ......    .#                          
                  #.       .........   ..      .              .......#         #.         ......    ..#                         
                  #.       .........   ..      .              ......#          #.         ......     .#                         
                  #.       .........   ..      .              .....#           #.         ......     .#                         
                  #.       .........   ..      .              .....#           #.         ......     .#                         
                  #.       .........   .........              ....#           #..         ......     .#                         
                  #.       .........   ..      .              ...#            #.          ......     .#                         
                  #.       .........   ..      .              ...#            #.          ......    ..#                         
                  #.       .........   ..      .              ...#            #.          ......    .#                          
                  #.       .........   ..      .              ...#            #.          ......    .#                          
                  #.       .........   ..      .              ....#          #..          ......   ..#                          
                  #.       ..............      .              ....#          #.           ...... ...#                           
                  #..      ..........   .      .              .....#         #.           ........##                            
                   #.      ..........   .      .              ... ..#        #.           .......#                              
                   #.      ..........   .      .              ...  .#       #..          ....####                               
                   #..     ..............      .              ...  ..#     #..        ....###                                   
                    #..    .........    .      .              ...   ..#####..        ..###                                      
                     #.    .........    .      .              ...    .......        ..#                                         
                     #..   .........    .      .              ...                   .#                                          
                      #..  .........    .      .              ...                   .#                                          
                       #.....................  .              ...                   .#                                          
                        ####################........          ...                   .#                                          
                                            #######..         ...                  ..#                                          
                                                   #..        ...                  .#                                           
                                                    #..       ...                  .#                                           
                                                     #..      ...                  .#                                           
                                                      #..     ...                 ..#                                           
                                                       #..    ...                ..#                                            
                                                        #..   ...                .#                                             
                                                         #.   ...                .#                                             
                                                         #... ...               ..#                                             
                                                          ##.....              ..#                                              
                                                            #....            ...#                                               
                                                            #....          ...##                                                
                                                             ##...      ....##                                                  
                                                               ##........###                                                    
                                                                 ########                                                       
                                                                                                                                
                                                                                                                                
                                                                                                                                
                                                                                                                                
                                                                                                                                
                                                                                                                                
                                                                                                                                
                                                                                                                                
                                                                                                                                
                                                                                                                                
