                                                                                                                                
                                                                                                                                
                                                                                                                                
                                                                                                                                
                                                                                                                                
                                                                                                                                
                                                                                                                                
                                                                                                                                
                                                                     #######                                                    
                                                                    #.......##                                                  
                                                                   #..     ...#                                                 
                                                                  #..        ..#                                                
                                                                 #..          ..#                                               
                                                                #..            .###  ##########                                 
                                                               #..             ....##..........##                               
                                                              #..                 ....        ...#                              
                                                  ###         #.                                ..#                             
                                            ######...###     #..                                 .#                             
                                           #....... ....#####..                                  ..#                            
                                          #..          .......                                    ..#                           
                                          #.                                                       .#                           
                                         #..                                                       ..#                          
                                         #.                                                         .#                          
                                        #..                                                         ..#                         
                                       #..                                                           .#                         
                                       #.                                                            .#                         
                                      #..                                                            ..#                        
                                     #..                                                              .##                       
                                    #..                                                               ...#                      
                                   #..                                                                  .#                      
                            #######..                                                                   .#                      
                        ####........                                                                    ..#                     
                     ###.....                                                                            ..#                    
                    #....                                                                                 .#                    
                   #..                                                                                    ..#                   
                   #.                                                                                      .#                   
                   #.                                                                                      ..#                  
                  #..                                                                                       .#                  
                  #.                                                                                       ..#                  
                  #.                                                                                     ...#                   
                  #.                                                                                    ..##                    
                  #.                                                                                   ..#                      
                  #.                                                                                   .#                       
                  #.                                                                                  ..#                       
                  #.                                                                                  .#                        
                  #.                                                                                 ..#                        
                  #.                                                                                 .#                         
                  #.                                                                                ..#                         
                  #.                                                                               ..#                          
                  #..                                                                              .#                           
                   #.                                                                              .#                           
                   #.                                                                             ..#                           
                   #..                                                                            .#                            
                    #.                                                                           ..#                            
                    #..                                                                          .#                             
                     #..                                                                        ..#                             
                      #..                                                                      ..#                              
                       #..                                                                     .#                               
                        #.                                                                     .#                               
                        #.                                                                     .#                               
                        #..                                                                    .#                               
                         #.                                                                    .#                               
                         #.                                                                    .#                               
                         #..                                                                   .#                               
                          #.                                    .                              .#                               
                          #.                                    .                              ..#                              
                          #.                                    .                               .##                             
                          #.                                    .                               ...#                            
                          #.                                    .                                 ..#                           
                          #.                                    .                                  ..#                          
                         #..                                    .                                   ..#                         
                         #.                                     .                                    ..#                        
                         #.                                     .                                     ..#                       
                         #.                                     .                                      ..#                      
                        #..                                     .                                       .#                      
                       #..                                      .                                       .#                      
                      #..                                       .                                   .....#                      
                    ##..                                        .                                   .#..#                       
                   #...                                         .                                   .#.#                        
                   #.                                           .                                   .##                         
                  #..                                           .                                   .#                          
                  #.                                            .                                   .#                          
                  #.                                            .                                   ..#                         
                  #.                                            .                                    .#                         
                  #.                                            .                                    .#                         
                  #.                                            .                                    .#                         
                  #.                                            .                                    .#                         
                  #.                                            .                                    .#                         
                  #.                                            .                                   ..#                         
                  #.                                            .                                   .#                          
                  #.                                            .                                   .#                          
                  #.                                            .                                  ..#                          
                  #.                                            .                                ...#                           
                  #..                                           .                               ..##                            
                   #.                                           .                           .....#                              
                   #.                                           .                        ....####                               
                   #..                                          .                     ....###                                   
                    #..                                         .                    ..###                                      
                     #.                                         .                   ..#                                         
                     #..                                        .                   .#                                          
                      #..                                       .                   .#                                          
                       #.....................                   .                   .#                                          
                        ####################........            .                   .#                                          
                                            #######..           .                  ..#                                          
                                                   #..          .                  .#                                           
                                                    #..         .                  .#                                           
                                                     #..        .                  .#                                           
                                                      #..       .                 ..#                                           
                                                       #..      .                ..#                                            
                                                        #..     .                .#                                             
                                                         #.     .                .#                                             
                                                         #...   .               ..#                                             
                                                          ##..  .              ..#                                              
                                                            #.  .            ...#                                               
                                                            #....          ...##                                                
                                                             ##...      ....##                                                  
                                                               ##........###                                                    
                                                                 ########                                                       
                                                                                                                                
                                                                                                                                
                                                                                                                                
                                                                                                                                
                                                                                                                                
                                                                                                                                
                                                                                                                                
                                                                                                                                
                                                                                                                                
                                                                                                                                
